login=LoginServlet
logout=LogoutServlet
index=login.jsp
managerPage=manage.jsp
createAccoutPage=register.jsp
register=RegisterServlet
createErrorPage=register.jsp
search=SearchControllerServlet
searchByName=SearchByNameServlet
searchByIsActive=SearchByIsActiveServlet
searchBySubject=SearchBySubjectServlet
createPage=create.jsp
createQuestion=CreateQuestionServlet
delete=DeleteQuestionServlet
updateShowPage=UpdatePageServlet
updatePage=update.jsp
updateQuestionPage=updatepage.jsp
LoadPage=LoadPageServlet
updateQuestion=UpdateQuestionServlet
QuizHomePage=QuizHomePageServlet
takeQuizPage=takequizhome.jsp
startQuiz=StartQuizServlet
quizController=QuizControllerServlet
quizPage=quiz.jsp
finishQuiz=FinishedQuizServlet
resultPage=resultpage.jsp
showHistory=ShowHistoryServlet
historyPage=history.jsp
showDetail=ShowDetailServlet
historyDetailPage=historydetail.jsp